adasaurus	dinosaur
adrvark	aardvark
afghan	Afghan_hound
africanelephant	elephant
africanhoneybee	Africanized_bee
alaskanhusky	Alaskan_husky
albinopython	albino_python
albinosloth	sloth
algaeeater	fish
aligator	alligator
aligators	alligator
americanbulldog	bulldog
americaneagle	eagle
angora	cat
animalsinthesea	animal
antlion	insect
anyfish	fish
aquaticus	Thermus_aquaticus
arcticwolf	wolf
ardvark	aardvark
ardvarrk	aardvark
armardillo	armadillo
arrowheadshark	shark
asalaut	ocelot
asiaticelephant	elephant
australianshepherd	shepherd
babboon	baboon
babybuffalo	buffalo
babychick	chick
babycow	cow
babycows	cow
babydog	dog
babyelephant	elephant
babyhorse	horse
babylion	lion
babyturtle	turtle
babywordforhorse	horse
babyzebra	zebra
bacterium	bacteria
baldeagle	bald_eagle
bananaballpython	python
bananaslug	banana_slug
bananaspider	spider
barnowl	barn_owl
barrelfish	fish
baskingshark	basking_shark
bassethound	basset_hound
batray	ray
bearcub	bear
beardeddragon	bearded_dragon
beatle	beetle
belugawhale	beluga_whale
bengalcat	cat
bengaltiger	bengal_tiger
beta	betta
betafish	betta_fish
bichonfrise	bichon
bigwhiteshark	shark
billygoat	billy_goat
bipedal	animal
blackant	ant
blackbear	bear
blackcat	cat
blackheadedgull	gull
blackhorse	horse
blacklab	black_labrador
blacklabrador	black_labrador
blackmamba	black_mamba
blackpanther	panther
blackrat	rat
blacksnake	snake
blacksquirrel	squirrel
blacktaileddeer	blacktail_deer
blacktiger	tiger
blacktipreefshark	blacktip_reef_shark
blackwidow	widow_spider
blackwidowspider	widow_spider
bluebelliedlizard	lizard
bluecat	cat
bluecrab	crab
bluefintuna	bluefin_tuna
bluefootedbooby	blue_footed_boobies
bluegillbass	bluegill
blueheron	blue_heron
bluejay	blue_jay
bluejaybird	blue_jay
bluerat	rat
bluewhale	whale
boaconstrictor	boa_constrictor
boacontstrictor	boa_constrictor
bollweevil	boll_weevil
bonobochimp	bonobo
bordercolley	border_collie
bordercollie	border_collie
borderterrier	terrier
bostonterrier	Boston_Terrier
bottlenoseddolphin	bottlenose_dolphin
bottlenosedolphin	bottlenose_dolphin
bottlenosewhale	bottlenose_whale
boxerjellyfish	jellyfish
boxjellyfish	jellyfish
brineshrimp	brine_shrimp
britishbulldog	bulldog
brownbear	bear
brownlab	labrador
brownlabrador	labrador
brownrecluse	brown_recluse
brownsnake	snake
brownthrasher	brown_thrasher
budgee	budgie
budgy	budgie
bugsintheground	bug
bulebird	bluebird
bullshark	bull_shark
bunnies	bunny
bunnyrabbit	bunny_rabbit
burmesecat	cat
californiagrizzly	grizzly
capuchinmonkey	capuchin_monkey
carnitaur	dinosaur
carpetshark	shark
carrierpigeon	carrier_pigeon
cattarpillar	caterpillar
cattle	cow
cetipede	centipede
chimpanse	chimpanzee
chimpanzoo	chimpanzee
chippingsparrow	sparrow
chiwawa	chihuahua
chocolatelab	chocolate_labrador
chow-chow	chow_chow
chowchow	chow_chow
cocatoo	cockatoo
cockerspaniel	cocker_spaniel
cockroaches	cockroach
coconutcrab	crab
colley	collie
cookiecuttershark	shark
copperchainmonkey	capuchin_monkey
copperheadsnake	copperhead_snake
coralsnake	coral_snake
cornsnake	snake
cottonmouth(snake)	cottonmouth
cottonmouthsnake	cottonmouth
coyfish	koi_fish
crabspider	spider
crocadile	crocodile
croppie	crappie
croppy	crappie
cuckatoo	cockatoo
daddychick	chick
daddyhorse	horse
daddylion	lion
daddylong-leg	daddy_longlegs
daddylongleg	daddy_longlegs
daddylonglegs	daddy_longlegs
dalmation	dalmatian
darwin'sfinch	finch
darwinsfinch	finch
dashchund	daschund
datsun	daschund
dear	deer
deermouse	mouse
desertfox	fox
devilbird	devil
devilfish	fish
diamondback(snake)	diamondback
diamondbacksnake	diamond
dikdik	dik_dik
dinosaurus	dinosaur
dobermanpincher	doberman_pinscher
dodobird	dodo_bird
doormouse	dormouse
downyherring	herring
downywoodpecker	downy_woodpecker
dramaderry	dromedary
duckbilledplatypus	duckbilled_platypus
dwarfhamster	dwarf_hamster
eggret	egret
electriceel	eel
elephantseal	seal
emperorpenguin	emperor_penguin
englishsparrow	sparrow
fairyshrimp	fairy_shrimp
farret	ferret
fieldmouse	mouse
fieldsparrow	sparrow
fightingbetafish	betta_fish
fireant	ant
flyingfish	fish
flyingmonkey	monkey
flyingsquirrel	squirrel
foxterrier	fox_terrier
frenchbulldog	french_bulldog
freshwaterfish	freshwater_fish
fruitbat	bat
galapagosturtle	turtle
ganew	gnu
gardensnake	garter_snake
gardenspider	spider
gardnersnake	garter_snake
garenspider	spider
gartersnake	garter_snake
geese	goose
germanbulldog	bulldog
germanshepard	german_shepherd
germanshephard	german_shepherd
germanshepherd	german_shepherd
germanterrier	terrier
giantpanda	giant_panda
giantsquid	giant_squid
gianttortoise	giant_tortoise
giraffebaby	giraffe
girrafe	giraffe
goldeneagle	golden_eagle
goldenlabradorretriever	golden_labrador
goldenmarmot	marmot
goldenretriever	golden_retriever
goldenretriever`	golden_retriever
goldrenreteiver	golden_retriever
goliathbeetle	beetle
gorrila	gorilla
greatcondor	condor
greatdane	great_dane
greateryellowlegs	greater_yellowlegs
greathornedowl	great_horned_owl
greatnorthern	bird
greatwhite(shark)	shark
greatwhiteshark	shark
greensnake	snake
greyhounddog	greyhound
greytiger	tiger
greywolf	gray_wolf
grizzlybear	grizzly_bear
grizzlies	grizzly_bear
groundsquirrel	squirrel
guineapig	guinea_pig
guineapigs	guinea_pig
gunieapig	guinea_pig
gunneapig	guinea_pig
gulls	gull
hairlesscat	hairless_cat
hairywoodpecker	hairy_woodpecker
hammerheadshark	hammerhead_shark
hampster	hamster
harpyeagle	harpy_eagle
heffer	cow
herbivore	animal
herfered	cow
hermitcrab	hermit_crab
herringgull	herring_gull
hippoagain	hippo
hippotamus	hippopotamus
hollermonkey	howler_monkey
homosapian	homo_sapiens
homosapien	homo_sapiens
homosapiens	homo_sapiens
honeybadger	honey_badger
honeybee	honey_bee
hounddog	hound_dog
housefinch	finch
housemouse	mouse
howlermonkey	howler_monkey
howlingmonkey	howler_monkey
humpbackwhale	humpback_whale
ivorybill	ivory_billed
jackle	jackal
jackrabbit	jack_rabbit
jackrussel	jack_russell
jackrussellterrier	jack_russell_terrier
jackrusselterrier	jack_russell_terrier
japanesegiantkillerbee	bee
japanesehornet	hornet
jumpingspider	spider
killerbee	bee
killerfish	fish
killerwhale	killer_whale
killwhale	killer_whale
kingcobra	king_cobra
kingcrab	king_crab
kingpenguin	penguin
kingsalmon	king_salmon
kittycat	kitty_cat
koalabear	koala_bear
kodiakbear	bear
koifish	koi_fish
kolabear	koala_bear
komododragon	komodo_dragon
komotodragon	komodo_dragon
komotodragons	komodo_dragon
laboradorretriever	labrador_retriever
labradordog	labrador
labradorretriever	labrador_retriever
lama	llama
largedog	dog
laughinghyena	hyena
leach	leech
leamer	lemur
leapord	leopard
leapordfish	fish
leapordseal	leopard_seal
leapordshark	leopard_shark
leash	leech
lebanesepeople	person
lemonshark	shark
leopardseal	leopard_seal
leopardshark	leopard_shark
lesseryellowlegs	lesser_yellowlegs
lightningbug	bug
ligress	liger
linx	lynx
lizzard	lizard
lizards	lizard
longhairdatsun	daschund
longlegspider	daddy_longlegs
macaquemonkey	macaque_monkey
mackarel	mackerel
mackrel	mackerel
macreltuna	mackerel_tuna
mainecoon	Maine_coon
makoshark	mako_shark
manitee	manatee
manofwarbird	bird
manowarjellyfish	jellyfish
mantaray	manta_ray
marlonfish	marlin
mastif	mastiff
mayerclidesdale	clydesdale
mediumsizeddog	dog
mediumsizedelephant	elephant
mexicanpeople	person
mice	mouse
miniaturedatsun	daschund
miniaturehorse	horse
miniaturepony	miniature_pony
miniaturepoodle	miniature_poodle
minx	mink
misquito	mosquito
mointainlion	mountain_lion
molerat	mole_rat
mommatiger	tiger
mommyhorse	horse
monarchbutterfly	monarch_butterfly
monitorlizard	monitor_lizard
moonjellyfish	jellyfish
morningdove	mourning_dove
mountainbear	bear
mountaingoat	mountain_goat
mountainlion	mountain_lion
mountainsheep	sheep
moutaingoat	mountain_goat
moutainlion	mountain_lion
mouth	moth
muledeer	mule_deer
muscrat	muskrat
mussle	mussel
nakedmolerat	naked_mole_rat
nilecrocodile	Nile_crocodile
nurseshark	shark
oppossum	opossum
orangutang	orangutan
orcawhale	orca_whale
oriol	oriole
osikat	cat
ostrichbaby	ostrich
oxen	ox
pandabear	panda
parot	parrot
parrakeet	parakeet
passengerpidgin	pigeon
pekingese	Pekingese
pembrokewelshcorgi	Pembroke_Welsh_corgi
people	person
peregrinefalcon	peregrine_falcon
persian	Persian
persiancat	cat
pest	insect
petmice	mouse
pidgeon	pigeon
pidgeons	pigeon
pike	fish
pileatedwoodpecker	pileated_woodpecker
pillbug	bug
pincherbug	pincher
pinksalmon	salmon
pinto(horse)	pinto_horse
pintohorse	pinto_horse
pirhana	piranha
pitbull	pit_bull
platyus	platypus
poisondarkfrog	poison_dart_frog
poisondartfrog	poison_dart_frog
polarbear	polar_bear
pomerian	pomeranian
porpous	porpoise
portugueseman-of-war	jellyfish
portuguesemanofwar	jellyfish
potbelliedpig	potbellied_pig
potbellypig	potbellied_pig
potto	Potto
prairiedog	prairie_dog
prariedog	prairie_dog
prayingmantis	praying_mantis
prayingmodaypractice	praying_mantis
pterydactyl	pterodactyl
purplefinch	purple_finch
pygmyelephant	pygmy_elephant
quadrapedal	animal
quakerparakeet	parakeet
quetzel	quetzal
raccon	raccoon
racoon	raccoon
racoons	raccoon
rainbowfish	fish
raindeer	reindeer
ratterrier	rat_terrier
redant	ant
redbreastedwoodpecker	red_bellied_woodpecker
redbudredheadedwoodpecker	red_bellied_woodpecker
redfox	fox
redmonkey	monkey
redpanda	panda
redrumpedagouti	agouti
redshoulderedhawk	red_shouldered_hawk
redsnapper	red_snapper
redtailedhawk	red_tailed_hawk
redtailedhog	hog
redtailedsquirrel	squirrel
redtailhawk	red_tailed_hawk
redwingedblackbird	red_winged_blackbird
regularbuffalo	buffalo
regulartiger	tiger
rhesusmonkey	rhesus_monkey
rhinocerosbeetle	rhinoceros_beetle
rhinocerous	rhinoceros
rhinocerus	rhinoceros
rhinosauras	rhinoceros
ringtailedlemur	ring_tailed_lemur
rollypolly	roly_polies
roly-poly	roly_polies
rosiatedtern	roseate_tern
rotweiler	rottweiler
sabertoothcat	saber_toothed_cat
sabertoothtiger	saber_toothed_tiger
saintbernard	dog
saintbernards	dog
salamandar	salamander
saltwatercrocodile	saltwater_crocodile
saltwaterfish	saltwater_fish
sandcrab	crab
sanddollar	sea_urchin
schitzu	shih_tzu
scottishterrier	Scottish_terrier
screechowl	screech_owl
seaanemone	sea_anemone
seaanenami	sea_anemone
seaanenome	sea_anemone
seacucumber	sea_cucumber
seal`	seal
sealion	sea_lion
seaotter	sea_otter
seasnail	snail
seasnake	snake
seastar	starfish
seaturtle	sea_turtle
seaurchin	sea_urchin
seaurchins	urchin
seamonkey	brine_shrimp
sharpei	Shar_Pei
shepherddog	shepherd
shihtzu	shih_tzu
shitzu	shih_tzu
siamesecat	Siamese_cat
siberianhusky	Siberian_husky
siberiantiger	Siberian_tiger
silverbackgorilla	silverback_gorilla
silvertailfox	fox
smallbird	bird
snake	lizard
snake-lizard	snake
snakelizard	lizard
snappingturtle	snapping_turtle
snowbird	bird
snowcrab	crab
snowfox	fox
snowleapord	snow_leopard
snowleopard	snow_leopard
snowlion	lion
snowmonkey	monkey
snowtiger	tiger
snowyowl	snowy_owl
societyfinch	finch
songsparrow	sparrow
songthrush	song_thrush
southafricanpenguin	penguin
spermwhale	sperm_whale
spidermonkey	spider_monkey
spinosaurus	Spinosaurus
spinydogfishshark	spiny_dogfish_shark
st.bernard	dog
stagbeetle	stag_beetle
standardpoodle	poodle
stbernard	dog
stickbug	bug
stickinsect	insect
sting-ray	stingray
stringray	stingray
striper(fish)	striper
striperfish	striper
sugarglider	glider
sunbear	bear
swai(fish)	fish
swaifish	fish
swardfish	swordfish
t-rex	t_rex
tabycat	tabby_cat
tamandua	anteater
taper	tapir
tasmaniandevel	Tasmanian_devil
tasmaniandevil	Tasmanian_devil
tazmaniandevil	Tasmanian_devil
teacupchiwawa	teacup_chihuahua
tetrafish	tetra
thoroughbred(horse)	thoroughbred
thoroughbredhorse	thoroughbred
tigar	tiger
tigers?	tiger
tigershark	tiger_shark
timberwolf	wolf
tortise	tortoise
toypoodle	toy_poodle
trapdoorspider	trapdoor_spider
treeshrew	tree_shrew
treesnake	snake
trex	t_rex
trumpetfish	fish
tryannosaurusrex	tyrannosaurus_rex
tucan	toucan
tunafish	tuna
turkeybuzzard	turkey_buzzard
turkeyvulture	turkey_vulture
turtledove	turtle_dove
tyrannasaurusrex	tyrannosaurus_rex
tyrannosaurusrex	tyrannosaurus_rex
unicorn	pony
vampirebat	bat
vertebrae	vertebrate
walkingstick	insect
wallabee	wallaby
waterbuffalo	buffalo
watersnake	snake
weasle	weasel
weenerdog	wiener_dog
weinerdog	wiener_dog
welshpembrokecorgi	Pembroke_Welsh_corgi
westie	Westie
whaleshark	whale_shark
whitebear	bear
whitehorse	horse
whiterhino	rhino
whiteshark	shark
whitesnowleopard	snow_leopard
whitetaileddeer	white_tailed_deer
whitetiger	tiger
whitetipreefshark	reef_shark
wildboar	wild_boar
wilddog	dog
wildebeast	wildebeest
wildgoat	goat
wildsheep	sheep
wolfspider	wolf_spider
wolverine	weasel
wolves	wolf
woodpidgin	pigeon
woollymammoth	Woolly_mammoth
yardsnake	snake
yellowlab	yellow_labrador
yellowlabrador	yellow_labrador
yellowtailfish	yellowtail
yorkshireterrier	Yorkshire_terrier
zebrababy	zebra
pill_bug	bug
round_worm	bug
earth_worm	bug
sugar_glider	glider
quokka	wallaby
gopher_tortoise	tortoise
remora_fish	fish
woolly_mammoth	Woolly_mammoth
flying_fish	fish
bushbaby	squirrel
tasmanian_devil	Tasmanian_devil
black_bear	bear
brown_bear	bear
venus_flytrap	bug
flying_squirrel	squirrel
heifer	cow
holstein_cow	cow
jersey_cow	cow
mutt	dog
siamese_cat	siamesecat
yellow_jacket	bug
weevil	boll_weevil
carpenter_ant	ant
tree_frog	poison_dart_frog
miniature_horse	horse
miniature_pig	potbelliedpig
english_bulldog	bulldog